{
    "0": "cel",
    "1": "cla",
    "2": "flu",
    "3": "gac",
    "4": "gel",
    "5": "org",
    "6": "pia",
    "7": "sax",
    "8": "tru",
    "9": "vio",
    "10": "voi"
}